##########
#S   #   #
### ## # #
#     #  #
# ### ####
#   #    E
##########
