##########
#S#      #
# # ######
# #     E#
# ###### #
#        #
##########
