##########
#S#     ##
# # # ####
#   #    #
# ### #  #
#     #  E
##########
